D                                                                                        C
D						                        		 C
F     IBBBBBBBBBBBBBBBBBBBBBBBBBBBBBBBBBBBBBBBBBBBBBBBBBBBBBBBBBBBBBBBBBBBBBBBBBBBBBBBBBBE
D                                                                                        C
D                               oooo         oooo                                        C
D                               IBBJ         IBBJ                                        C
D                        oooo          oo2o        oooo              oooo                C
D                 ooo 2  IBBJ    2     IBBJ     2  IBBJ   oooo 2     IBBJ      2         C
D           2     IBJ      2        !    2         2      IBBJ      1      2     2       C
D           EBF                     EBF o o o o   2                IBJ           IBJ     C
D     1     CAD    1    1     1     CAD 2 1 EBF  1  2   1       1     1       1        * C
HBBBBBBBBBBBGAHBBBBBBBBBBBBBBBBBBBBBGAHBBBBBGAHBBBBBBBBBBBBBBBBBBBBBBBBBBBBBBBBBBBBBBBBBBG