AD                                                                                            CA
AD						                        		      CA
BF                                                                                o o  o  o o EB
AD          o - o                o o o o o o ----- o o 1 o o      2 o o - o 1 --    o  o  o   CA
AD        2IBBBBBJ      o 1 o   IBBBBBBBBBBBBBBBBBBBBBBBBBBBBJ   EBBBBBBBBBBBBBBF 2 o  2  o 2 CA
AD                     IBBBBBJ                                   CAAAAAAAAAAAAAAD   2  o  2   CA
AD                  2         -    2      o 2 o          o 1 o   CAAAAAAAAAAAAAAD    o o o    CA
AD        2         IBJ      IBJ        2 IBBBJ2        2IBBBJ   CAAAAAAAAAAAAAAD2oEBF 1 EBFo2CA
AD           2-               2     EBF 1       1  -  2       ---CAAAAAAAAAAAAAAD  GAHBBBGAH  CA
AD     EBF   IBJ                   IGAHBBBBBBBBBBBBBBBBBBBBBBBBBBGAAAAAAAAAAAAAAH  o o o o o  CA
AD1    CAD                                                                                  * CA
AHBBBBBGAHJ                                                                           IBBBBBBBGA